111111111111111111111111111111111111111111111111111
111111111111111111111111111111111111111111111111111
110000000000000000011000000000000000000000000000001
110000000000000000011000000000000000000000000000001
110000000000000000011000000000000000000000000000001
110000000000000000011000000000000000000000000000001
111111111111110000011000001111111111111111111111111
111111111111111000011000011111111111111111111111111
111111111101111000011000001111111111111110111111110
110000000000011000011000000000000000011000000000000
110000000000011000011000000000000000011000000000000
110000000000011000011000000000000000011000000000000
110000000000011000011000000000000000011000000000000
111111110000011000011111111111111000011000001111111
111111110000011000011111111111111000011000001111111
110000000000011000000000000000000000011000000000001
110000000000011000000000000000000000011000000000001
110000000000011000000000000000000000011000000000001
110000000000011000000000000000000000011000000000001
110000111111111000011000011111111111111000001000001
110000011111110000011000011111111111111000011100001
110000000000000000011000000000000000011000011100001
110000000000000000011000000000000000011000011100001
110000000000000000011000000000000000011000011100001
110000000000000000011000000000000000011000011100001
110000010000011111111111111111111000011111111100001
110000111000011111111111111111111000011111111000001
110000111000000000000000011000000000011000000000001
110000111000000000000000011000000000011000000000001
110000111000000000000000011000000000011000000000001
110000111000000000000000011000000000011000000000001
110000111111111111111000011000011000011111111000001
110000111111111111111000011000011000011111111100001
110000111000000000000000011000011000000000011100001
110000111000000000000000011000011000000000011100001
110000111000000000000000011000011000000000011100001
110000111000000000000000011000011000000000011100001
111111111000011111111111111000011111111000011100001
111111111000011111111111111000011111111000001000001
000000111000000000000000000000011000000000000000001
000000011000000000000000000000011000000000000000001
000000111000000000000000000000011000000000000000001
000000111000000000000000000000011000000000000000001
110000111000000000001011111111111000001111111111111
110000010000011000011111111111111000011111111111111
110000000000011000001101111111110000001111111111111
110000000000011000000000000000000000000000000000001
110000000000011000000000000000000000000000000000001
110000000000011000000000000000000000000000000000001
110000000000011000000000000000000000000000000000001
111111111111111111111111111111111111111111111111111
